NO ./textures/Spy_family_red.png
SO ./textures/Spy_family_cook.png
WE ./textures/Spy_family_portraits.png
EA ./textures/Spy_family_sleep.png

F 175, 96, 26 
C 97, 106, 107

111111111111111111111
100000000010000000001
100000000010000000001
100000000010000000001
100001000000000100001
100001000000000100001
100001000000000100N01
111111111111111111111