NO ./textures/blue_city1.png
SO ./textures/vermelho_city2.png
WE ./textures/vermelho_city1.png
EA ./textures/blue_city2.png


F 0, 0, 0
C 100, 100, 100

1111111
10000011111111
100000000000001111111111111111111
100000000000000000000001111111111111111111
100000000000000000000001111111111111111111
100000000000000000000001111111111111111111
100000000000000000000001111111111111111111
100000000000000000000001111111111111111111
100000000000000000000001111111111111111111
1000000000000000000000000000001111111
10000000000000100000000000000011
10000000000000N00000000000000011111111
10000000000000000000000000000011111111
10000000000000000000000000000011111111
10000000000000000001111111111111111111
10000000000000000001111111111111111111
10000000000000000001111111111111111111
10000000000000000001111111111111111111
10000000000000000001111111111111111111
100000000001111111111111111111
111111111111
