NO ./textures/Saitama.png
SO ./textures/Spiderman.png
WE ./textures/green_eyes.png
EA ./textures/Assasins_creed.png

F 50, 150, 20
C 10, 54, 55

1111111111111111
1100000100000001
1000000000000001
1000000000000001
100000000W000001
1000000000000001
1000000000000001
100000000000000111111
1000000000000000000001
100000000000000111111
1111111111111111
