NO ./textures/redbrick.png
SO ./textures/eagle.png
WE ./textures/hola.png
EA ./textures/bluestone.png

C 78, 55, 19
F 30, 30, 30

1111111111111111111111111
100000000110000000000001 1
1011000001110000000000001
100100000000000W0000000111111111
111111111011000001110000000000001
100000000011000001110111111111111
11110111111111011100000010001
11110111111111011101010010001
11000000110101011100000010001
10000000000000001100000010001
10000000000000001101010010001
110000011101010111110111100111
11110111 1110101 101111010001
11111111 1111111 111111111111