NO ./textures/north_texture.png
SO ./textures/south_texture.png
WE ./textures/west_texture.png
EA ./textures/east_texture.png

F 19, 64, 65
C 43, 158, 160

        1
       101
      10001
     1000001
    100000001
   10000000001
  1000001000001
 100000000000001
11111000000011111
    1000N0001
    100000001
    100000001
    100000001
    100000001
    100000001
    100000001
    100000001
    100000001
    100000001
    111111111
