NO ./textures/Assasins_creed.png
SO ./textures/Automata.png
WE ./textures/Saitama_ok.png
EA ./textures/green_eyes.png

F 175, 96, 26 
C 97, 106, 107

111111111111111111111
100000000010000000001
10000000000000000W1001
100000000000011111111
100000000000000000001
100000000000000000001
100000000000000010001
100001000000000100001
111111111111111111111